bul	Bulgarian
cat	Catalan
ces	Czech
chi_sim	Simplified Chinese
chi_tra	Traditional Chinese
dan-frak	Danish (Fraktur)
dan	Danish
deu	German
ell	Greek
eng	English
fin	Finnish
fra	French
hun	Hungarian
ind	Indonesian
ita	Italian
jpn	Japanese
kor	Korean
lav	Latvian
lit	Lithuanian
nld	Dutch
nor	Norwegian
pol	Polish
por	Portuguese
ron	Romanian
rus	Russian
slk	Slovakian
slv	Slovenian
spa	Spanish
srp	Serbian
swe	Swedish
tgl	Tagalog
tha	Thai
tur	Turkish
ukr	Ukrainian
vie	Vietnamese
